##############################
#............................#
#............................#
#............................#
#..........#.................#
#............................#
#..................#.........#
#............................#
#............................#
#............................#
#........#...................#
#.......................#....#
#.......................#....#
#...............#.......#....#
#.......................#....#
#.......................#....#
#...#......#............#....#
#.......................#....#
#.......................#....#
#............................#
#............................#
#.......############.........#
#............................#
#.....................#......#
#............................#
#............................#
#............................#
#............................#
#............................#
##############################
